60, NULL
61, NULL
62, NULL
63, NULL
64, NULL
65, NULL
66, NULL
67, NULL
68, NULL
69, NULL
70, NULL
71, NULL
72, NULL
73, NULL
74, NULL
75, NULL
76, NULL
77, NULL
78, NULL
79, NULL
80, NULL
81, NULL
82, NULL
83, NULL
84, NULL
85, NULL
86, NULL
87, NULL
88, NULL
89, NULL
90, NULL
91, NULL
94, NULL
95, NULL
96, NULL
97, NULL
98, NULL
99, NULL
100, NULL
101, NULL
102, NULL
103, NULL
104, NULL
105, NULL
106, NULL
107, NULL
108, NULL
109, NULL
110, NULL
111, NULL
112, NULL
113, NULL
114, NULL
115, NULL
116, NULL
117, NULL
118, NULL
119, NULL
120, NULL
121, NULL
122, NULL
123, NULL
124, NULL
21, NULL
41, NULL
43, NULL
44, NULL
45, NULL
46, NULL
47, NULL
48, NULL
49, NULL
50, NULL
51, NULL
52, NULL
53, NULL
54, NULL
55, NULL
56, NULL
57, NULL
58, NULL
59, NULL
92, NULL
93, NULL
125, NULL
39, Drums, 34, 81
	1, 0, 0, 34, 127, 116, 0, 120, 64
	1, 1, 0, 35, 127, 127, 127, 120, 64
	1, 1, 0, 35, 127, 127, 127, 120, 64
	1, 1, 0, 35, 127, 127, 127, 120, 64
	1, 1, 0, 35, 127, 127, 127, 120, 64
	1, 2, 0, 42, 127, 100, 0, 120, 80
	1, 2, 0, 42, 127, 100, 0, 120, 80
	1, 2, 0, 42, 127, 100, 0, 120, 80
	1, 2, 0, 42, 127, 100, 0, 120, 80
	1, 2, 0, 42, 127, 100, 0, 120, 80
	1, 2, 0, 42, 127, 100, 0, 120, 80
	1, 3, 0, 46, 127, 102, 0, 120, 80
	1, 3, 0, 46, 127, 102, 0, 120, 80
	1, 3, 0, 46, 127, 102, 0, 120, 80
	1, 3, 0, 46, 127, 102, 0, 120, 80
	1, 3, 0, 46, 127, 102, 0, 120, 80
	1, 3, 0, 46, 127, 102, 0, 120, 80
	1, 3, 0, 46, 127, 102, 0, 120, 80
	1, 3, 0, 46, 127, 102, 0, 120, 80
	1, 3, 0, 46, 127, 102, 0, 120, 80
	1, 3, 0, 46, 127, 102, 0, 120, 80
	1, 3, 0, 46, 127, 102, 0, 120, 80
	1, 3, 0, 46, 127, 102, 0, 120, 80
	1, 3, 0, 46, 127, 102, 0, 120, 80
	1, 3, 0, 46, 127, 102, 0, 120, 80
	1, 3, 0, 46, 127, 102, 0, 120, 80
	1, 3, 0, 46, 127, 102, 0, 120, 80
	1, 3, 0, 46, 127, 102, 0, 120, 80
	1, 3, 0, 46, 127, 102, 0, 120, 80
	1, 3, 0, 46, 127, 102, 0, 120, 80
	1, 4, 0, 80, 127, 120, 0, 125, 44
	1, 4, 0, 80, 127, 120, 0, 125, 44
	1, 4, 0, 80, 127, 120, 0, 125, 44
	1, 4, 0, 80, 127, 120, 0, 125, 44
	1, 4, 0, 80, 127, 120, 0, 125, 44
	1, 4, 0, 80, 127, 120, 0, 125, 44
	1, 4, 0, 80, 127, 120, 0, 125, 44
	1, 4, 0, 80, 127, 120, 0, 125, 44
	1, 4, 0, 80, 127, 120, 0, 125, 44
	1, 4, 0, 80, 127, 120, 0, 125, 44
	1, 4, 0, 80, 127, 120, 0, 125, 44
	1, 4, 0, 80, 127, 120, 0, 125, 44
	1, 4, 0, 80, 127, 120, 0, 125, 44
	1, 4, 0, 80, 127, 120, 0, 125, 44
	1, 4, 0, 80, 127, 120, 0, 125, 44
	1, 4, 0, 80, 127, 120, 0, 125, 44
	1, 4, 0, 80, 127, 120, 0, 125, 44
	1, 4, 0, 81, 127, 80, 0, 118, 44
40, NULL
13, NULL
1, NULL
19, NULL
36, NULL
31, NULL
25, Keysplit, 48, 57, 127, 0, 0, 0, 0, 0
	1, 5, 0, 43, 120, 100, 127, 116, 64
	1, 6, 0, 52, 120, 90, 127, 116, 64
	1, 7, 0, 60, 120, 90, 127, 116, 64
34, NULL
18, NULL
17, NULL
11, NULL
16, NULL
3, NULL
4, NULL
32, NULL
20, NULL
9, NULL
0, NULL
27, Keysplit, 55, 67, 127, 0, 0, 0, 0, 0
	1, 8, 0, 48, 127, 80, 1, 116, 64
	1, 9, 0, 60, 127, 90, 1, 116, 64
	1, 10, 0, 72, 127, 100, 1, 116, 64
42, NULL
6, NULL
10, Keysplit, 67, 79, 127, 0, 0, 0, 0, 0
	1, 11, 0, 60, 127, 90, 1, 116, 64
	1, 12, 0, 72, 127, 90, 1, 116, 64
	1, 13, 0, 84, 127, 90, 1, 116, 64
14, NULL
33, Keysplit, 69, 76, 127, 0, 0, 0, 0, 0
	1, 14, 0, 64, 127, 100, 110, 114, 64
	1, 15, 0, 72, 127, 100, 110, 114, 64
	1, 16, 0, 81, 127, 100, 110, 114, 64
2, NULL
37, NULL
12, NULL
35, NULL
26, NULL
15, NULL
23, Keysplit, 65, 74, 83, 127, 0, 0, 0, 0
	1, 17, 0, 60, 127, 100, 110, 118, 64
	1, 18, 0, 69, 127, 100, 110, 118, 64
	1, 19, 0, 77, 122, 100, 110, 118, 64
	1, 20, 0, 84, 122, 100, 110, 118, 64
22, Keysplit, 43, 127, 0, 0, 0, 0, 0, 0
	1, 21, 0, 36, 127, 125, 120, 120, 64
	1, 22, 0, 48, 127, 125, 120, 120, 64
38, NULL
28, NULL
30, NULL
29, NULL
8, NULL
5, NULL
24, NULL
7, NULL
